##################################################
#@....#....######......###........#..............#
#.....#.........#.................#........#.....#
##..####..##....#....##....................#.....#
#...#.....................#########......######..#
#...#..........#..........#.......#..............#
#.....#........#..........#.......#..............#
#.....#........#..........#.......#######........#
#######################..........................#
#...............#.....#..........................#
#...............#.....#..###################.....#
#...............###...#....................#.....#
#...............#..........................#.....#
#.....#........#.........########..........#.....#
#.....#.........#........#.................#.....#
#.....#..........#.......#.................#.....#
#.....#.........#........#.................#.....#
#.....#.......#..........###################.....#
#.....#........#.................................#
#.....#.........#................................#
#.....#..........................................#
#.....#...................#########......#########
#.....#####################......................#
#.................................####...........#
#.................................#..............#
##################################################